29
29
PPPPPPPPPPPPPPPPPPPPPPPPPPPPP
PPPPPPPPPPPPPPPPPPPPPPPPPPPPP
PPPPPPPPPPPPPPPPPPPPPPPPPPPPP
PPPBBBSSSABBSSTSSSSSSSTTTSPPP
PPPBBBBBBABBSSTSTSTSTSSTTSPPP
PPPBBBSSBABSSSSTSTSTSTSSSSPPP
PPPBBBBSBASSSSBDBXTSTSSSSSPPP
PPPBBBBBBBASSXBBBTSTSTSSSSPPP
PPPBBBBBBSSASTTSTSTSSSXSSSPPP
PPPBBBBBBSSASTTSTSTSSSXSSSPPP
PPPBBBBBBSSASTTSTSTSSSXSSSPPP
PPPBBBBBBSSASTTSTSTSSSXSSSPPP
PPPSSSTTTTTTTSSTTTTTTTTSSSPPP
PPPSSSTTTTTTTSTTTTTTTTTSSSPPP
PPPTSTSTTTSTSTSSSTSTSTSTSTSPP
PPTSTSTTTSTSTSSSTSTSTSTSTSPPP
PPPTSTSTTTSTSTSSSTSTSTSTSTSPP
PPPSTSTTTSTSTSSSTSTSTSTSTSPPP
PPPTSTSTTTSTSTSSSTSTSTSTSTSPP
PPPSTSTTTSTSTSSSTSTSTSTSTSPPP
PPPTSTSTTTSTSTSSSTSTSTSTSTSPP
PPPSTSTTTSTSTSSSTSTSTSTSTSPPP
PPTSTSTSTSTSTSSSTSTSTSTSTSPPP
PPPSTSTSTSTSTSSSTSTSTSTSTSPPP
PPTSTSTTTSTSTSSSTSTSTSTSTSPPP
PPPSTSTTTSTSTSSSTSTSTSTSTSPPP
PPPPPPPPPPPPPPPPPPPPPPPPPPPPP
PPPPPPPPPPPPPPPPPPPPPPPPPPPPP
PPPPPPPPPPPPPPPPPPPPPPPPPPPPP
